##############
#            #
#            #
#     aO     #
#   aOaOaO   #
#     aO     #
#            #
#Oa   P    aO#
##############
