##############
#            #
#            #
#  P   aO    #
#    a  O    #
#      aO    #
#            #
#            #
##############
