##############
#            #
#            #
#     aO     #
#   aOaOaO   #
#     aO     #
# Oa  P      #
##############
